[Picture]
bigMap.png
[Region,X,Y,Neibor Regions]
1,110,63,2,4,14,13,5,12,11,6
2,321,65,1,,4,3
3,151,188,2,4,15,16
4,458,51,2,3,1,15,14
5,372,173,1,13
6,185,275,1,11,7
7,598,38,6,11,10,8
8,595,160,7,10,9
9,480,299,8,10,,22,23
10,392,315,7,11,21,22,9,8
11,307,403,1,6,12,21,10,7
12,139,390,1,11,21,20,19,13
13,841,48,1,5,12,14,19
14,718,132,1,4,15,18,19,13
15,736,256,4,3,16,17,18,14
16,600,316,15,3,24,17
17,473,420,15,16,24,25,26,18
18,920,154,14,15,17,26,28,27,19
19,895,255,14,18,27,20,12,13
20,838,347,19,27,28,21,12
21,719,404,12,20,28,29,22,10,11
22,603,451,29,23,9,10,21
23,900,453,9,22,29,30
24,333,902,16,38,25,17
25,422,367,17,24,38,37,36,26
26,356,674,28,18,17,25,36,35
27,567,444,28,20,19,18
28,789,890,21,20,27,18,26,35,34,33,32,29
29,345,890,22,21,28,32,31,30,23
30,123,890,23,39,31,44
31,321,890,29,32,44,30
32,456,890,28,33,43,44,31,29
33,456,890,28,34,42,43,32
34,456,890,28,35,40,41,42,33
35,456,890,28,26,36,40,34
36,456,890,35,26,25,37,39,40
37,456,890,36,25,38,39
38,456,890,24,25,37
39,456,890,37,36,40
40,456,890,39,36,35,34,41
41,456,890,40,34,42,47
42,456,890,34,41,47,46,43,33
43,456,890,33,42,46,45,44,32
44,456,890,32,43,45,30,31,32
45,456,890,44,43,46,48
46,456,890,47,42,43,45,48
47,456,890,41,42,46
48,456,890,45,46
49,0,0,50
50,0,0,49